F 78, 65, 88
C 252, 220, 182

SO ./drawable/lake.xpm
WE ./drawable/field.xpm
EA ./drawable/island.xpm
NO    ./drawable/town.xpm


        111111111111 11111111111111111
        11110000000111000000000111111111
        101100000111000000N0100000100101
        10010000000000000000000011111111
111111111011000001110000000000001    1
10000000001100000111011111111111111111
11110111111111011100000010001
1111011111111101110101001000111111111111
1100000011010101110000010000000000000011
1000000000000000110000001000111111111101111111111111111
10000000000000001101010010001        111
1100000111010101111101111000111
11110111 1110101 101111010001
11111111 1111111 111111111111