
NO    ./drawable/heart0.xpm
SO ./drawable/saturn.xpm
WE ./drawable/sky.xpm
EA ./drawable/view.xpm

F 78, 65, 88
C 252, 220, 182



111111
1E0121
100221
100021
111111