F 78, 65, 88
C 252, 220, 182

SO ./drawable/lake.xpm
WE ./drawable/field.xpm
EA ./drawable/island.xpm
NO    ./drawable/town.xpm


111111111111111111111111111111111111111111111111111111111111111
100000000000000000000000000000000000000000000000000000000000011
100000000002000000000000000000000000000000000000000000000000111
1N0000000111111000111111111111111111110000000011111111111100001
111111001111110001111111111111111111100000000111111111111000011
     1001111110001111111111111111111100000000111111111111000011
     1001111110000000000000000000000000000000000000000000000011
     1001111110001111111111111111100011111111111111111111111111
111111001111110001111111111000000000000000011111111111111111111
10000000111111000111111111100000000000000001111111111111111111
10000200111111000111111111100000000000000001111111111111111111
12000000001000000111111111100000000000000001111111111111111111
11111111111111111111111111111111111111111111111111111111111111
                                                             1
                                                             1
                                                             1
                                                             1
                                                             1
                                                             1
                                                             1
11111111111111111111111111111111111111111111111111111111111111
