F 78, 65, 88
C 252, 220, 182

SO ./drawable/lake.xpm
WE ./drawable/field.xpm
EA ./drawable/island.xpm
NO    ./drawable/town.xpm

11111111111111111111111111111111111111111111111111111111111111
10000000000000000000000000000000000000000000000000000000000001
1N000000000200000000000000000000000000000000000000000000000001
10000000111111000111111111111111111110000000011111111111100001
11111100111111000111111111111111111110000000011111111111100001
     100111111000111111111111111111110000000011111111111100001
     100111111000000000000000000000000000000000000000000000001
     100111111000111111111111111110001111111111111111111111111
11111100111111000111111111100000000000000001111111111111111111
10000000111111000111111111100000000000000001111111111111111111
10000200111111000111111111100000000000000001111111111111111111
12000000000000000111111111100000000000000001111111111111111111
11111111111111111111111111111111111111111111111111111111111111